Date,Country_code,Country,WHO_region,New_cases,Cumulative_cases,New_deaths,Cumulative_deaths
2020/1/30,GB,The United Kingdom,EURO,1,1,0,0
2020/1/31,GB,The United Kingdom,EURO,0,1,0,0
2020/2/1,GB,The United Kingdom,EURO,0,1,0,0
2020/2/2,GB,The United Kingdom,EURO,1,2,0,0
2020/2/3,GB,The United Kingdom,EURO,19,21,0,0
2020/2/4,GB,The United Kingdom,EURO,0,21,0,0
2020/2/5,GB,The United Kingdom,EURO,1,22,0,0
2020/2/6,GB,The United Kingdom,EURO,0,22,0,0
2020/2/7,GB,The United Kingdom,EURO,0,22,0,0
2020/2/8,GB,The United Kingdom,EURO,3,25,0,0
2020/2/9,GB,The United Kingdom,EURO,1,26,0,0
2020/2/10,GB,The United Kingdom,EURO,1,27,0,0
2020/2/11,GB,The United Kingdom,EURO,4,31,0,0
2020/2/12,GB,The United Kingdom,EURO,1,32,0,0
2020/2/13,GB,The United Kingdom,EURO,1,33,0,0
2020/2/14,GB,The United Kingdom,EURO,0,33,0,0
2020/2/15,GB,The United Kingdom,EURO,0,33,0,0
2020/2/16,GB,The United Kingdom,EURO,0,33,0,0
2020/2/17,GB,The United Kingdom,EURO,1,34,0,0
2020/2/18,GB,The United Kingdom,EURO,0,34,0,0
2020/2/19,GB,The United Kingdom,EURO,0,34,0,0
2020/2/20,GB,The United Kingdom,EURO,0,34,0,0
2020/2/21,GB,The United Kingdom,EURO,2,36,0,0
2020/2/22,GB,The United Kingdom,EURO,0,36,0,0
2020/2/23,GB,The United Kingdom,EURO,6,42,0,0
2020/2/24,GB,The United Kingdom,EURO,2,44,0,0
2020/2/25,GB,The United Kingdom,EURO,3,47,0,0
2020/2/26,GB,The United Kingdom,EURO,2,49,0,0
2020/2/27,GB,The United Kingdom,EURO,8,57,0,0
2020/2/28,GB,The United Kingdom,EURO,12,69,0,0
2020/2/29,GB,The United Kingdom,EURO,4,73,0,0
2020/3/1,GB,The United Kingdom,EURO,20,93,0,0
2020/3/2,GB,The United Kingdom,EURO,41,134,1,1
2020/3/3,GB,The United Kingdom,EURO,57,191,2,3
2020/3/4,GB,The United Kingdom,EURO,56,247,0,3
2020/3/5,GB,The United Kingdom,EURO,49,296,3,6
2020/3/6,GB,The United Kingdom,EURO,83,379,0,6
2020/3/7,GB,The United Kingdom,EURO,68,447,0,6
2020/3/8,GB,The United Kingdom,EURO,55,502,3,9
2020/3/9,GB,The United Kingdom,EURO,148,650,5,14
2020/3/10,GB,The United Kingdom,EURO,265,915,3,17
2020/3/11,GB,The United Kingdom,EURO,403,1318,8,25
2020/3/12,GB,The United Kingdom,EURO,484,1802,13,38
2020/3/13,GB,The United Kingdom,EURO,478,2280,16,54
2020/3/14,GB,The United Kingdom,EURO,352,2632,22,76
2020/3/15,GB,The United Kingdom,EURO,441,3073,32,108
2020/3/16,GB,The United Kingdom,EURO,602,3675,47,155
2020/3/17,GB,The United Kingdom,EURO,783,4458,52,207
2020/3/18,GB,The United Kingdom,EURO,985,5443,68,275
2020/3/19,GB,The United Kingdom,EURO,1042,6485,73,348
2020/3/20,GB,The United Kingdom,EURO,1252,7737,109,457
2020/3/21,GB,The United Kingdom,EURO,1181,8918,130,587
2020/3/22,GB,The United Kingdom,EURO,1363,10281,164,751
2020/3/23,GB,The United Kingdom,EURO,2290,12571,186,937
2020/3/24,GB,The United Kingdom,EURO,2354,14925,237,1174
2020/3/25,GB,The United Kingdom,EURO,2666,17591,303,1477
2020/3/26,GB,The United Kingdom,EURO,3039,20630,362,1839
2020/3/27,GB,The United Kingdom,EURO,3154,23784,398,2237
2020/3/28,GB,The United Kingdom,EURO,2774,26558,436,2673
2020/3/29,GB,The United Kingdom,EURO,2818,29376,506,3179
2020/3/30,GB,The United Kingdom,EURO,4195,33571,589,3768
2020/3/31,GB,The United Kingdom,EURO,4463,38034,662,4430
2020/4/1,GB,The United Kingdom,EURO,4891,42925,769,5199
2020/4/2,GB,The United Kingdom,EURO,4824,47749,806,6005
2020/4/3,GB,The United Kingdom,EURO,4852,52601,840,6845
2020/4/4,GB,The United Kingdom,EURO,3976,56577,907,7752
2020/4/5,GB,The United Kingdom,EURO,3556,60133,917,8669
2020/4/6,GB,The United Kingdom,EURO,5273,65406,895,9564
2020/4/7,GB,The United Kingdom,EURO,5477,70883,998,10562
2020/4/8,GB,The United Kingdom,EURO,5146,76029,1076,11638
2020/4/9,GB,The United Kingdom,EURO,4875,80904,1003,12641
2020/4/10,GB,The United Kingdom,EURO,4327,85231,944,13585
2020/4/11,GB,The United Kingdom,EURO,3585,88816,956,14541
2020/4/12,GB,The United Kingdom,EURO,3507,92323,958,15499
2020/4/13,GB,The United Kingdom,EURO,4203,96526,896,16395
2020/4/14,GB,The United Kingdom,EURO,4335,100861,857,17252
2020/4/15,GB,The United Kingdom,EURO,5070,105931,878,18130
2020/4/16,GB,The United Kingdom,EURO,5292,111223,843,18973
2020/4/17,GB,The United Kingdom,EURO,4977,116200,819,19792
2020/4/18,GB,The United Kingdom,EURO,4743,120943,800,20592
2020/4/19,GB,The United Kingdom,EURO,3881,124824,770,21362
2020/4/20,GB,The United Kingdom,EURO,4441,129265,783,22145
2020/4/21,GB,The United Kingdom,EURO,4795,134060,745,22890
2020/4/22,GB,The United Kingdom,EURO,5517,139577,731,23621
2020/4/23,GB,The United Kingdom,EURO,5167,144744,678,24299
2020/4/24,GB,The United Kingdom,EURO,4961,149705,683,24982
2020/4/25,GB,The United Kingdom,EURO,3757,153462,647,25629
2020/4/26,GB,The United Kingdom,EURO,3476,156938,633,26262
2020/4/27,GB,The United Kingdom,EURO,4739,161677,595,26857
2020/4/28,GB,The United Kingdom,EURO,4720,166397,559,27416
2020/4/29,GB,The United Kingdom,EURO,5433,171830,573,27989
2020/4/30,GB,The United Kingdom,EURO,4961,176791,551,28540
2020/5/1,GB,The United Kingdom,EURO,4766,181557,568,29108
2020/5/2,GB,The United Kingdom,EURO,3258,184815,494,29602
2020/5/3,GB,The United Kingdom,EURO,3002,187817,450,30052
2020/5/4,GB,The United Kingdom,EURO,3398,191215,484,30536
2020/5/5,GB,The United Kingdom,EURO,3686,194901,465,31001
2020/5/6,GB,The United Kingdom,EURO,3832,198733,460,31461
2020/5/7,GB,The United Kingdom,EURO,3787,202520,461,31922
2020/5/8,GB,The United Kingdom,EURO,3064,205584,384,32306
2020/5/9,GB,The United Kingdom,EURO,2170,207754,378,32684
2020/5/10,GB,The United Kingdom,EURO,2337,210091,348,33032
2020/5/11,GB,The United Kingdom,EURO,3612,213703,309,33341
2020/5/12,GB,The United Kingdom,EURO,3410,217113,321,33662
2020/5/13,GB,The United Kingdom,EURO,3330,220443,317,33979
2020/5/14,GB,The United Kingdom,EURO,2630,223073,334,34313
2020/5/15,GB,The United Kingdom,EURO,2530,225603,314,34627
2020/5/16,GB,The United Kingdom,EURO,2082,227685,314,34941
2020/5/17,GB,The United Kingdom,EURO,1837,229522,267,35208
2020/5/18,GB,The United Kingdom,EURO,2581,232103,293,35501
2020/5/19,GB,The United Kingdom,EURO,3063,235166,275,35776
2020/5/20,GB,The United Kingdom,EURO,2719,237885,268,36044
2020/5/21,GB,The United Kingdom,EURO,2567,240452,238,36282
2020/5/22,GB,The United Kingdom,EURO,2057,242509,223,36505
2020/5/23,GB,The United Kingdom,EURO,1531,244040,220,36725
2020/5/24,GB,The United Kingdom,EURO,1373,245413,197,36922
2020/5/25,GB,The United Kingdom,EURO,1625,247038,200,37122
2020/5/26,GB,The United Kingdom,EURO,2070,249108,214,37336
2020/5/27,GB,The United Kingdom,EURO,1825,250933,198,37534
2020/5/28,GB,The United Kingdom,EURO,1757,252690,217,37751
2020/5/29,GB,The United Kingdom,EURO,1531,254221,186,37937
2020/5/30,GB,The United Kingdom,EURO,1132,255353,163,38100
2020/5/31,GB,The United Kingdom,EURO,1080,256433,127,38227
2020/6/1,GB,The United Kingdom,EURO,1438,257871,134,38361
2020/6/2,GB,The United Kingdom,EURO,1492,259363,168,38529
2020/6/3,GB,The United Kingdom,EURO,1369,260732,155,38684
2020/6/4,GB,The United Kingdom,EURO,1249,261981,134,38818
2020/6/5,GB,The United Kingdom,EURO,1123,263104,123,38941
2020/6/6,GB,The United Kingdom,EURO,804,263908,110,39051
2020/6/7,GB,The United Kingdom,EURO,722,264630,128,39179
2020/6/8,GB,The United Kingdom,EURO,1099,265729,125,39304
2020/6/9,GB,The United Kingdom,EURO,1165,266894,90,39394
2020/6/10,GB,The United Kingdom,EURO,1196,268090,109,39503
2020/6/11,GB,The United Kingdom,EURO,1013,269103,80,39583
2020/6/12,GB,The United Kingdom,EURO,1053,270156,80,39663
2020/6/13,GB,The United Kingdom,EURO,886,271042,63,39726
2020/6/14,GB,The United Kingdom,EURO,826,271868,86,39812
2020/6/15,GB,The United Kingdom,EURO,1045,272913,72,39884
2020/6/16,GB,The United Kingdom,EURO,1103,274016,84,39968
2020/6/17,GB,The United Kingdom,EURO,1017,275033,59,40027
2020/6/18,GB,The United Kingdom,EURO,1022,276055,61,40088
2020/6/19,GB,The United Kingdom,EURO,993,277048,52,40140
2020/6/20,GB,The United Kingdom,EURO,683,277731,60,40200
2020/6/21,GB,The United Kingdom,EURO,636,278367,54,40254
2020/6/22,GB,The United Kingdom,EURO,899,279266,64,40318
2020/6/23,GB,The United Kingdom,EURO,883,280149,65,40383
2020/6/24,GB,The United Kingdom,EURO,777,280926,74,40457
2020/6/25,GB,The United Kingdom,EURO,726,281652,68,40525
2020/6/26,GB,The United Kingdom,EURO,666,282318,41,40566
2020/6/27,GB,The United Kingdom,EURO,653,282971,49,40615
2020/6/28,GB,The United Kingdom,EURO,449,283420,45,40660
2020/6/29,GB,The United Kingdom,EURO,724,284144,39,40699
2020/6/30,GB,The United Kingdom,EURO,623,284767,47,40746
2020/7/1,GB,The United Kingdom,EURO,652,285419,26,40772
2020/7/2,GB,The United Kingdom,EURO,606,286025,43,40815
2020/7/3,GB,The United Kingdom,EURO,568,286593,29,40844
2020/7/4,GB,The United Kingdom,EURO,399,286992,33,40877
2020/7/5,GB,The United Kingdom,EURO,558,287550,27,40904
2020/7/6,GB,The United Kingdom,EURO,714,288264,36,40940
2020/7/7,GB,The United Kingdom,EURO,608,288872,27,40967
2020/7/8,GB,The United Kingdom,EURO,713,289585,24,40991
2020/7/9,GB,The United Kingdom,EURO,722,290307,37,41028
2020/7/10,GB,The United Kingdom,EURO,568,290875,22,41050
2020/7/11,GB,The United Kingdom,EURO,459,291334,21,41071
2020/7/12,GB,The United Kingdom,EURO,366,291700,14,41085
2020/7/13,GB,The United Kingdom,EURO,740,292440,25,41110
2020/7/14,GB,The United Kingdom,EURO,705,293145,21,41131
2020/7/15,GB,The United Kingdom,EURO,777,293922,20,41151
2020/7/16,GB,The United Kingdom,EURO,712,294634,13,41164
2020/7/17,GB,The United Kingdom,EURO,582,295216,18,41182
2020/7/18,GB,The United Kingdom,EURO,505,295721,14,41196
2020/7/19,GB,The United Kingdom,EURO,448,296169,14,41210
2020/7/20,GB,The United Kingdom,EURO,830,296999,12,41222
2020/7/21,GB,The United Kingdom,EURO,788,297787,20,41242
2020/7/22,GB,The United Kingdom,EURO,816,298603,18,41260
2020/7/23,GB,The United Kingdom,EURO,808,299411,16,41276
2020/7/24,GB,The United Kingdom,EURO,774,300185,7,41283
2020/7/25,GB,The United Kingdom,EURO,530,300715,17,41300
2020/7/26,GB,The United Kingdom,EURO,563,301278,17,41317
2020/7/27,GB,The United Kingdom,EURO,869,302147,12,41329
2020/7/28,GB,The United Kingdom,EURO,856,303003,12,41341
2020/7/29,GB,The United Kingdom,EURO,1062,304065,12,41353
2020/7/30,GB,The United Kingdom,EURO,946,305011,10,41363
2020/7/31,GB,The United Kingdom,EURO,697,305708,14,41377
2020/8/1,GB,The United Kingdom,EURO,559,306267,11,41388
2020/8/2,GB,The United Kingdom,EURO,564,306831,10,41398
2020/8/3,GB,The United Kingdom,EURO,1060,307891,16,41414
2020/8/4,GB,The United Kingdom,EURO,1065,308956,14,41428
2020/8/5,GB,The United Kingdom,EURO,1092,310048,6,41434
2020/8/6,GB,The United Kingdom,EURO,1105,311153,9,41443
2020/8/7,GB,The United Kingdom,EURO,973,312126,13,41456
2020/8/8,GB,The United Kingdom,EURO,710,312836,14,41470
2020/8/9,GB,The United Kingdom,EURO,627,313463,9,41479
2020/8/10,GB,The United Kingdom,EURO,1499,314962,13,41492
2020/8/11,GB,The United Kingdom,EURO,1378,316340,10,41502
2020/8/12,GB,The United Kingdom,EURO,1242,317582,7,41509
2020/8/13,GB,The United Kingdom,EURO,1156,318738,9,41518
2020/8/14,GB,The United Kingdom,EURO,1185,319923,7,41525
2020/8/15,GB,The United Kingdom,EURO,714,320637,12,41537
2020/8/16,GB,The United Kingdom,EURO,602,321239,4,41541
2020/8/17,GB,The United Kingdom,EURO,1298,322537,12,41553
2020/8/18,GB,The United Kingdom,EURO,1116,323653,9,41562
2020/8/19,GB,The United Kingdom,EURO,1282,324935,4,41566
2020/8/20,GB,The United Kingdom,EURO,1498,326433,8,41574
2020/8/21,GB,The United Kingdom,EURO,1218,327651,7,41581
2020/8/22,GB,The United Kingdom,EURO,842,328493,9,41590
2020/8/23,GB,The United Kingdom,EURO,831,329324,16,41606
2020/8/24,GB,The United Kingdom,EURO,1301,330625,6,41612
2020/8/25,GB,The United Kingdom,EURO,1270,331895,12,41624
2020/8/26,GB,The United Kingdom,EURO,1388,333283,11,41635
2020/8/27,GB,The United Kingdom,EURO,1591,334874,9,41644
2020/8/28,GB,The United Kingdom,EURO,1632,336506,11,41655
2020/8/29,GB,The United Kingdom,EURO,1230,337736,5,41660
2020/8/30,GB,The United Kingdom,EURO,1171,338907,6,41666
2020/8/31,GB,The United Kingdom,EURO,1513,340420,10,41676
2020/9/1,GB,The United Kingdom,EURO,2288,342708,5,41681
2020/9/2,GB,The United Kingdom,EURO,3077,345785,10,41691
2020/9/3,GB,The United Kingdom,EURO,3152,348937,10,41701
2020/9/4,GB,The United Kingdom,EURO,3092,352029,9,41710
2020/9/5,GB,The United Kingdom,EURO,2551,354580,13,41723
2020/9/6,GB,The United Kingdom,EURO,2465,357045,9,41732
2020/9/7,GB,The United Kingdom,EURO,3931,360976,15,41747
2020/9/8,GB,The United Kingdom,EURO,3370,364346,10,41757
2020/9/9,GB,The United Kingdom,EURO,3365,367711,10,41767
2020/9/10,GB,The United Kingdom,EURO,3628,371339,13,41780
2020/9/11,GB,The United Kingdom,EURO,3324,374663,13,41793
2020/9/12,GB,The United Kingdom,EURO,2670,377333,18,41811
2020/9/13,GB,The United Kingdom,EURO,2154,379487,17,41828
2020/9/14,GB,The United Kingdom,EURO,3428,382915,21,41849
2020/9/15,GB,The United Kingdom,EURO,3551,386466,18,41867
2020/9/16,GB,The United Kingdom,EURO,4399,390865,27,41894
2020/9/17,GB,The United Kingdom,EURO,4676,395541,28,41922
2020/9/18,GB,The United Kingdom,EURO,4973,400514,24,41946
2020/9/19,GB,The United Kingdom,EURO,4889,405403,20,41966
2020/9/20,GB,The United Kingdom,EURO,5340,410743,32,41998
2020/9/21,GB,The United Kingdom,EURO,5627,416370,27,42025
2020/9/22,GB,The United Kingdom,EURO,6441,422811,40,42065
2020/9/23,GB,The United Kingdom,EURO,7096,429907,58,42123
2020/9/24,GB,The United Kingdom,EURO,7682,437589,35,42158
2020/9/25,GB,The United Kingdom,EURO,7318,444907,33,42191
2020/9/26,GB,The United Kingdom,EURO,6809,451716,39,42230
2020/9/27,GB,The United Kingdom,EURO,7023,458739,49,42279
2020/9/28,GB,The United Kingdom,EURO,9983,468722,54,42333
2020/9/29,GB,The United Kingdom,EURO,10368,479090,48,42381
2020/9/30,GB,The United Kingdom,EURO,12717,491807,57,42438
2020/10/1,GB,The United Kingdom,EURO,13358,505165,67,42505
2020/10/2,GB,The United Kingdom,EURO,13854,519019,70,42575
2020/10/3,GB,The United Kingdom,EURO,11667,530686,67,42642
2020/10/4,GB,The United Kingdom,EURO,11954,542640,60,42702
2020/10/5,GB,The United Kingdom,EURO,16755,559395,72,42774
2020/10/6,GB,The United Kingdom,EURO,17250,576645,71,42845
2020/10/7,GB,The United Kingdom,EURO,18576,595221,102,42947
2020/10/8,GB,The United Kingdom,EURO,18427,613648,95,43042
2020/10/9,GB,The United Kingdom,EURO,15903,629551,80,43122
2020/10/10,GB,The United Kingdom,EURO,12652,642203,104,43226
2020/10/11,GB,The United Kingdom,EURO,12213,654416,125,43351
2020/10/12,GB,The United Kingdom,EURO,19710,674126,113,43464
2020/10/13,GB,The United Kingdom,EURO,19135,693261,111,43575
2020/10/14,GB,The United Kingdom,EURO,19934,713195,117,43692
2020/10/15,GB,The United Kingdom,EURO,18639,731834,151,43843
2020/10/16,GB,The United Kingdom,EURO,17938,749772,150,43993
2020/10/17,GB,The United Kingdom,EURO,14888,764660,179,44172
2020/10/18,GB,The United Kingdom,EURO,14331,778991,161,44333
2020/10/19,GB,The United Kingdom,EURO,25926,804917,192,44525
2020/10/20,GB,The United Kingdom,EURO,25680,830597,200,44725
2020/10/21,GB,The United Kingdom,EURO,25785,856382,221,44946
2020/10/22,GB,The United Kingdom,EURO,23497,879879,236,45182
2020/10/23,GB,The United Kingdom,EURO,21714,901593,224,45406
2020/10/24,GB,The United Kingdom,EURO,16464,918057,213,45619
2020/10/25,GB,The United Kingdom,EURO,15905,933962,252,45871
2020/10/26,GB,The United Kingdom,EURO,26807,960769,281,46152
2020/10/27,GB,The United Kingdom,EURO,24360,985129,268,46420
2020/10/28,GB,The United Kingdom,EURO,23907,1009036,287,46707
2020/10/29,GB,The United Kingdom,EURO,23649,1032685,314,47021
2020/10/30,GB,The United Kingdom,EURO,22896,1055581,340,47361
2020/10/31,GB,The United Kingdom,EURO,16702,1072283,325,47686
2020/11/1,GB,The United Kingdom,EURO,16001,1088284,360,48046
2020/11/2,GB,The United Kingdom,EURO,32003,1120287,339,48385
2020/11/3,GB,The United Kingdom,EURO,25989,1146276,362,48747
2020/11/4,GB,The United Kingdom,EURO,24055,1170331,329,49076
2020/11/5,GB,The United Kingdom,EURO,24102,1194433,380,49456
2020/11/6,GB,The United Kingdom,EURO,23714,1218147,402,49858
2020/11/7,GB,The United Kingdom,EURO,18783,1236930,394,50252
2020/11/8,GB,The United Kingdom,EURO,20252,1257182,415,50667
2020/11/9,GB,The United Kingdom,EURO,31558,1288740,486,51153
2020/11/10,GB,The United Kingdom,EURO,27829,1316569,391,51544
2020/11/11,GB,The United Kingdom,EURO,27792,1344361,390,51934
2020/11/12,GB,The United Kingdom,EURO,24876,1369237,422,52356
2020/11/13,GB,The United Kingdom,EURO,24438,1393675,437,52793
2020/11/14,GB,The United Kingdom,EURO,18258,1411933,435,53228
2020/11/15,GB,The United Kingdom,EURO,16258,1428191,456,53684
2020/11/16,GB,The United Kingdom,EURO,27007,1455198,423,54107
2020/11/17,GB,The United Kingdom,EURO,23531,1478729,444,54551
2020/11/18,GB,The United Kingdom,EURO,21118,1499847,489,55040
2020/11/19,GB,The United Kingdom,EURO,18074,1517921,463,55503
2020/11/20,GB,The United Kingdom,EURO,17134,1535055,454,55957
2020/11/21,GB,The United Kingdom,EURO,12556,1547611,467,56424
2020/11/22,GB,The United Kingdom,EURO,11913,1559524,477,56901
2020/11/23,GB,The United Kingdom,EURO,19083,1578607,464,57365
2020/11/24,GB,The United Kingdom,EURO,16704,1595311,464,57829
2020/11/25,GB,The United Kingdom,EURO,16858,1612169,487,58316
2020/11/26,GB,The United Kingdom,EURO,14817,1626986,433,58749
2020/11/27,GB,The United Kingdom,EURO,14597,1641583,426,59175
2020/11/28,GB,The United Kingdom,EURO,11105,1652688,471,59646
2020/11/29,GB,The United Kingdom,EURO,10874,1663562,466,60112
2020/11/30,GB,The United Kingdom,EURO,18265,1681827,423,60535
2020/12/1,GB,The United Kingdom,EURO,16745,1698572,399,60934
2020/12/2,GB,The United Kingdom,EURO,16748,1715320,387,61321
2020/12/3,GB,The United Kingdom,EURO,15926,1731246,474,61795
2020/12/4,GB,The United Kingdom,EURO,15866,1747112,475,62270
2020/12/5,GB,The United Kingdom,EURO,12917,1760029,395,62665
2020/12/6,GB,The United Kingdom,EURO,13765,1773794,421,63086
2020/12/7,GB,The United Kingdom,EURO,21644,1795438,425,63511
2020/12/8,GB,The United Kingdom,EURO,21097,1816535,436,63947
2020/12/9,GB,The United Kingdom,EURO,21937,1838472,432,64379
2020/12/10,GB,The United Kingdom,EURO,22927,1861399,449,64828
2020/12/11,GB,The United Kingdom,EURO,24425,1885824,454,65282
2020/12/12,GB,The United Kingdom,EURO,19592,1905416,438,65720
2020/12/13,GB,The United Kingdom,EURO,22279,1927695,419,66139
2020/12/14,GB,The United Kingdom,EURO,35221,1962916,480,66619
2020/12/15,GB,The United Kingdom,EURO,34414,1997330,461,67080
2020/12/16,GB,The United Kingdom,EURO,35438,2032768,432,67512
2020/12/17,GB,The United Kingdom,EURO,34440,2067208,538,68050
2020/12/18,GB,The United Kingdom,EURO,36418,2103626,515,68565
2020/12/19,GB,The United Kingdom,EURO,25589,2129215,490,69055
2020/12/20,GB,The United Kingdom,EURO,33064,2162279,505,69560
2020/12/21,GB,The United Kingdom,EURO,48192,2210471,576,70136
2020/12/22,GB,The United Kingdom,EURO,46476,2256947,564,70700
2020/12/23,GB,The United Kingdom,EURO,42936,2299883,566,71266
2020/12/24,GB,The United Kingdom,EURO,32391,2332274,584,71850
2020/12/25,GB,The United Kingdom,EURO,14419,2346693,615,72465
2020/12/26,GB,The United Kingdom,EURO,41109,2387802,657,73122
2020/12/27,GB,The United Kingdom,EURO,48519,2436321,658,73780
2020/12/28,GB,The United Kingdom,EURO,46407,2482728,679,74459
2020/12/29,GB,The United Kingdom,EURO,83088,2565816,660,75119
2020/12/30,GB,The United Kingdom,EURO,72161,2637977,722,75841
2020/12/31,GB,The United Kingdom,EURO,53945,2691922,758,76599
2021/1/1,GB,The United Kingdom,EURO,32482,2724404,750,77349
2021/1/2,GB,The United Kingdom,EURO,61654,2786058,762,78111
2021/1/3,GB,The United Kingdom,EURO,56333,2842391,760,78871
2021/1/4,GB,The United Kingdom,EURO,77970,2920361,845,79716
2021/1/5,GB,The United Kingdom,EURO,66636,2986997,909,80625
2021/1/6,GB,The United Kingdom,EURO,58784,3045781,936,81561
2021/1/7,GB,The United Kingdom,EURO,53187,3098968,996,82557
2021/1/8,GB,The United Kingdom,EURO,48103,3147071,987,83544
2021/1/9,GB,The United Kingdom,EURO,40035,3187106,1023,84567
2021/1/10,GB,The United Kingdom,EURO,37174,3224280,1099,85666
2021/1/11,GB,The United Kingdom,EURO,58591,3282871,1131,86797
2021/1/12,GB,The United Kingdom,EURO,50647,3333518,1213,88010
2021/1/13,GB,The United Kingdom,EURO,46506,3380024,1219,89229
2021/1/14,GB,The United Kingdom,EURO,43473,3423497,1231,90460
2021/1/15,GB,The United Kingdom,EURO,41450,3464947,1227,91687
2021/1/16,GB,The United Kingdom,EURO,31247,3496194,1310,92997
2021/1/17,GB,The United Kingdom,EURO,29592,3525786,1270,94267
2021/1/18,GB,The United Kingdom,EURO,45956,3571742,1298,95565
2021/1/19,GB,The United Kingdom,EURO,40525,3612267,1364,96929
2021/1/20,GB,The United Kingdom,EURO,35985,3648252,1300,98229
2021/1/21,GB,The United Kingdom,EURO,32501,3680753,1237,99466
2021/1/22,GB,The United Kingdom,EURO,30330,3711083,1245,100711
2021/1/23,GB,The United Kingdom,EURO,22344,3733427,1171,101882
2021/1/24,GB,The United Kingdom,EURO,17554,3750981,1159,103041
2021/1/25,GB,The United Kingdom,EURO,30736,3781717,1169,104210
2021/1/26,GB,The United Kingdom,EURO,27730,3809447,1066,105276
2021/1/27,GB,The United Kingdom,EURO,26303,3835750,1115,106391
2021/1/28,GB,The United Kingdom,EURO,24772,3860522,1110,107501
2021/1/29,GB,The United Kingdom,EURO,22433,3882955,1069,108570
2021/1/30,GB,The United Kingdom,EURO,17167,3900122,914,109484
2021/1/31,GB,The United Kingdom,EURO,15783,3915905,895,110379
2021/2/1,GB,The United Kingdom,EURO,22971,3938876,896,111275
2021/2/2,GB,The United Kingdom,EURO,20268,3959144,852,112127
2021/2/3,GB,The United Kingdom,EURO,19914,3979058,859,112986
2021/2/4,GB,The United Kingdom,EURO,18493,3997551,719,113705
2021/2/5,GB,The United Kingdom,EURO,16308,4013859,753,114458
2021/2/6,GB,The United Kingdom,EURO,12320,4026179,702,115160
2021/2/7,GB,The United Kingdom,EURO,11664,4037843,637,115797
2021/2/8,GB,The United Kingdom,EURO,16193,4054036,680,116477
2021/2/9,GB,The United Kingdom,EURO,14225,4068261,611,117088
2021/2/10,GB,The United Kingdom,EURO,13899,4082160,609,117697
2021/2/11,GB,The United Kingdom,EURO,13139,4095299,576,118273
2021/2/12,GB,The United Kingdom,EURO,12573,4107872,534,118807
2021/2/13,GB,The United Kingdom,EURO,9034,4116906,491,119298
2021/2/14,GB,The United Kingdom,EURO,8994,4125900,496,119794
2021/2/15,GB,The United Kingdom,EURO,14735,4140635,518,120312
2021/2/16,GB,The United Kingdom,EURO,12941,4153576,447,120759
2021/2/17,GB,The United Kingdom,EURO,11942,4165518,431,121190
2021/2/18,GB,The United Kingdom,EURO,11794,4177312,418,121608
2021/2/19,GB,The United Kingdom,EURO,10728,4188040,382,121990
2021/2/20,GB,The United Kingdom,EURO,8312,4196352,353,122343
2021/2/21,GB,The United Kingdom,EURO,8097,4204449,326,122669
2021/2/22,GB,The United Kingdom,EURO,11655,4216104,282,122951
2021/2/23,GB,The United Kingdom,EURO,9762,4225866,289,123240
2021/2/24,GB,The United Kingdom,EURO,8845,4234711,275,123515
2021/2/25,GB,The United Kingdom,EURO,8025,4242736,260,123775
2021/2/26,GB,The United Kingdom,EURO,6783,4249519,228,124003
2021/2/27,GB,The United Kingdom,EURO,4949,4254468,230,124233
2021/2/28,GB,The United Kingdom,EURO,4873,4259341,212,124445
2021/3/1,GB,The United Kingdom,EURO,7192,4266533,224,124669
2021/3/2,GB,The United Kingdom,EURO,6919,4273452,184,124853
2021/3/3,GB,The United Kingdom,EURO,6172,4279624,147,125000
2021/3/4,GB,The United Kingdom,EURO,5937,4285561,154,125154
2021/3/5,GB,The United Kingdom,EURO,5467,4291028,169,125323
2021/3/6,GB,The United Kingdom,EURO,4628,4295656,152,125475
2021/3/7,GB,The United Kingdom,EURO,4410,4300066,133,125608
2021/3/8,GB,The United Kingdom,EURO,6890,4306956,144,125752
2021/3/9,GB,The United Kingdom,EURO,6487,4313443,137,125889
2021/3/10,GB,The United Kingdom,EURO,6251,4319694,118,126007
2021/3/11,GB,The United Kingdom,EURO,5933,4325627,124,126131
2021/3/12,GB,The United Kingdom,EURO,5716,4331343,92,126223
2021/3/13,GB,The United Kingdom,EURO,4379,4335722,107,126330
2021/3/14,GB,The United Kingdom,EURO,4425,4340147,98,126428
2021/3/15,GB,The United Kingdom,EURO,6697,4346844,95,126523
2021/3/16,GB,The United Kingdom,EURO,5849,4352693,83,126606
2021/3/17,GB,The United Kingdom,EURO,5976,4358669,80,126686
2021/3/18,GB,The United Kingdom,EURO,5623,4364292,58,126744
2021/3/19,GB,The United Kingdom,EURO,5176,4369468,70,126814
2021/3/20,GB,The United Kingdom,EURO,4246,4373714,64,126878
2021/3/21,GB,The United Kingdom,EURO,5388,4379102,81,126959
2021/3/22,GB,The United Kingdom,EURO,6458,4385560,67,127026
2021/3/23,GB,The United Kingdom,EURO,5481,4391041,52,127078
2021/3/24,GB,The United Kingdom,EURO,6222,4397263,41,127119
2021/3/25,GB,The United Kingdom,EURO,5616,4402879,46,127165
2021/3/26,GB,The United Kingdom,EURO,4567,4407446,48,127213
2021/3/27,GB,The United Kingdom,EURO,3731,4411177,39,127252
2021/3/28,GB,The United Kingdom,EURO,5029,4416206,34,127286
2021/3/29,GB,The United Kingdom,EURO,4196,4420402,36,127322
2021/3/30,GB,The United Kingdom,EURO,3779,4424181,43,127365
2021/3/31,GB,The United Kingdom,EURO,3967,4428148,39,127404
2021/4/1,GB,The United Kingdom,EURO,3674,4431822,32,127436
2021/4/2,GB,The United Kingdom,EURO,2747,4434569,31,127467
2021/4/3,GB,The United Kingdom,EURO,2506,4437075,31,127498
2021/4/4,GB,The United Kingdom,EURO,2412,4439487,27,127525
2021/4/5,GB,The United Kingdom,EURO,2744,4442231,18,127543
2021/4/6,GB,The United Kingdom,EURO,3312,4445543,28,127571
2021/4/7,GB,The United Kingdom,EURO,3253,4448796,28,127599
2021/4/8,GB,The United Kingdom,EURO,3147,4451943,36,127635
2021/4/9,GB,The United Kingdom,EURO,2952,4454895,26,127661
2021/4/10,GB,The United Kingdom,EURO,2380,4457275,25,127686
2021/4/11,GB,The United Kingdom,EURO,2376,4459651,24,127710
2021/4/12,GB,The United Kingdom,EURO,2878,4462529,29,127739
2021/4/13,GB,The United Kingdom,EURO,2495,4465024,21,127760
2021/4/14,GB,The United Kingdom,EURO,2512,4467536,17,127777
2021/4/15,GB,The United Kingdom,EURO,2344,4469880,22,127799
2021/4/16,GB,The United Kingdom,EURO,2347,4472227,18,127817
2021/4/17,GB,The United Kingdom,EURO,1721,4473948,25,127842
2021/4/18,GB,The United Kingdom,EURO,2584,4476532,18,127860
2021/4/19,GB,The United Kingdom,EURO,2738,4479270,18,127878
2021/4/20,GB,The United Kingdom,EURO,2541,4481811,19,127897
2021/4/21,GB,The United Kingdom,EURO,2709,4484520,24,127921
2021/4/22,GB,The United Kingdom,EURO,2409,4486929,17,127938
2021/4/23,GB,The United Kingdom,EURO,2020,4488949,23,127961
2021/4/24,GB,The United Kingdom,EURO,1564,4490513,8,127969
2021/4/25,GB,The United Kingdom,EURO,2119,4492632,15,127984
2021/4/26,GB,The United Kingdom,EURO,2625,4495257,14,127998
2021/4/27,GB,The United Kingdom,EURO,2178,4497435,16,128014
2021/4/28,GB,The United Kingdom,EURO,2499,4499934,16,128030
2021/4/29,GB,The United Kingdom,EURO,2230,4502164,16,128046
2021/4/30,GB,The United Kingdom,EURO,1825,4503989,12,128058
2021/5/1,GB,The United Kingdom,EURO,1431,4505420,9,128067
2021/5/2,GB,The United Kingdom,EURO,1521,4506941,14,128081
2021/5/3,GB,The United Kingdom,EURO,2084,4509025,10,128091
2021/5/4,GB,The United Kingdom,EURO,2550,4511575,10,128101
2021/5/5,GB,The United Kingdom,EURO,2568,4514143,13,128114
2021/5/6,GB,The United Kingdom,EURO,2325,4516468,11,128125
2021/5/7,GB,The United Kingdom,EURO,1981,4518449,12,128137
2021/5/8,GB,The United Kingdom,EURO,1606,4520055,9,128146
2021/5/9,GB,The United Kingdom,EURO,2307,4522362,9,128155
2021/5/10,GB,The United Kingdom,EURO,2808,4525170,10,128165
2021/5/11,GB,The United Kingdom,EURO,2328,4527498,15,128180
2021/5/12,GB,The United Kingdom,EURO,2335,4529833,11,128191
2021/5/13,GB,The United Kingdom,EURO,2182,4532015,7,128198
2021/5/14,GB,The United Kingdom,EURO,1936,4533951,6,128204
2021/5/15,GB,The United Kingdom,EURO,1626,4535577,8,128212
2021/5/16,GB,The United Kingdom,EURO,1922,4537499,8,128220
2021/5/17,GB,The United Kingdom,EURO,2858,4540357,8,128228
2021/5/18,GB,The United Kingdom,EURO,2812,4543169,6,128234
2021/5/19,GB,The United Kingdom,EURO,2812,4545981,5,128239
2021/5/20,GB,The United Kingdom,EURO,2517,4548498,6,128245
2021/5/21,GB,The United Kingdom,EURO,2365,4550863,10,128255
2021/5/22,GB,The United Kingdom,EURO,2000,4552863,5,128260
2021/5/23,GB,The United Kingdom,EURO,2326,4555189,9,128269
2021/5/24,GB,The United Kingdom,EURO,3368,4558557,9,128278
2021/5/25,GB,The United Kingdom,EURO,3427,4561984,7,128285
2021/5/26,GB,The United Kingdom,EURO,3921,4565905,13,128298
2021/5/27,GB,The United Kingdom,EURO,3747,4569652,9,128307
2021/5/28,GB,The United Kingdom,EURO,3589,4573241,8,128315
2021/5/29,GB,The United Kingdom,EURO,2999,4576240,9,128324
2021/5/30,GB,The United Kingdom,EURO,3164,4579404,9,128333
2021/5/31,GB,The United Kingdom,EURO,3897,4583301,8,128341
2021/6/1,GB,The United Kingdom,EURO,5431,4588732,4,128345
2021/6/2,GB,The United Kingdom,EURO,6168,4594900,13,128358
2021/6/3,GB,The United Kingdom,EURO,6256,4601156,12,128370
2021/6/4,GB,The United Kingdom,EURO,5859,4607015,13,128383
2021/6/5,GB,The United Kingdom,EURO,4731,4611746,7,128390
2021/6/6,GB,The United Kingdom,EURO,5533,4617279,8,128398
2021/6/7,GB,The United Kingdom,EURO,7945,4625224,6,128404
2021/6/8,GB,The United Kingdom,EURO,7896,4633120,10,128414
2021/6/9,GB,The United Kingdom,EURO,8209,4641329,9,128423
2021/6/10,GB,The United Kingdom,EURO,8042,4649371,11,128434
2021/6/11,GB,The United Kingdom,EURO,7619,4656990,6,128440
2021/6/12,GB,The United Kingdom,EURO,6284,4663274,14,128454
2021/6/13,GB,The United Kingdom,EURO,7135,4670409,10,128464
2021/6/14,GB,The United Kingdom,EURO,10362,4680771,10,128474
2021/6/15,GB,The United Kingdom,EURO,10795,4691566,21,128495
2021/6/16,GB,The United Kingdom,EURO,11051,4702617,13,128508
2021/6/17,GB,The United Kingdom,EURO,11106,4713723,6,128514
2021/6/18,GB,The United Kingdom,EURO,10320,4724043,12,128526
2021/6/19,GB,The United Kingdom,EURO,8445,4732488,23,128549
2021/6/20,GB,The United Kingdom,EURO,10087,4742575,25,128574
2021/6/21,GB,The United Kingdom,EURO,16307,4758882,16,128590
2021/6/22,GB,The United Kingdom,EURO,17403,4776285,13,128603
2021/6/23,GB,The United Kingdom,EURO,18350,4794635,8,128611
2021/6/24,GB,The United Kingdom,EURO,18712,4813347,23,128634
2021/6/25,GB,The United Kingdom,EURO,18169,4831516,22,128656
2021/6/26,GB,The United Kingdom,EURO,16300,4847816,17,128673
2021/6/27,GB,The United Kingdom,EURO,18502,4866318,22,128695
2021/6/28,GB,The United Kingdom,EURO,28418,4894736,13,128708
2021/6/29,GB,The United Kingdom,EURO,28199,4922935,24,128732
2021/6/30,GB,The United Kingdom,EURO,28922,4951857,22,128754
2021/7/1,GB,The United Kingdom,EURO,28794,4980651,25,128779
2021/7/2,GB,The United Kingdom,EURO,26340,5006991,28,128807
2021/7/3,GB,The United Kingdom,EURO,24006,5030997,29,128836
2021/7/4,GB,The United Kingdom,EURO,25155,5056152,29,128865
2021/7/5,GB,The United Kingdom,EURO,34896,5091048,29,128894
2021/7/6,GB,The United Kingdom,EURO,36041,5127089,32,128926
2021/7/7,GB,The United Kingdom,EURO,38593,5165682,29,128955
2021/7/8,GB,The United Kingdom,EURO,33999,5199681,42,128997
2021/7/9,GB,The United Kingdom,EURO,32799,5232480,48,129045
2021/7/10,GB,The United Kingdom,EURO,28373,5260853,42,129087
2021/7/11,GB,The United Kingdom,EURO,30502,5291355,34,129121
2021/7/12,GB,The United Kingdom,EURO,44505,5335860,41,129162
2021/7/13,GB,The United Kingdom,EURO,47702,5383562,50,129212
2021/7/14,GB,The United Kingdom,EURO,54908,5438470,43,129255
2021/7/15,GB,The United Kingdom,EURO,61996,5500466,52,129307
2021/7/16,GB,The United Kingdom,EURO,55262,5555728,52,129359
2021/7/17,GB,The United Kingdom,EURO,38473,5594201,52,129411
2021/7/18,GB,The United Kingdom,EURO,36180,5630381,69,129480
2021/7/19,GB,The United Kingdom,EURO,47910,5678291,82,129562
2021/7/20,GB,The United Kingdom,EURO,39869,5718160,58,129620
2021/7/21,GB,The United Kingdom,EURO,35535,5753695,55,129675
2021/7/22,GB,The United Kingdom,EURO,31274,5784969,77,129752
2021/7/23,GB,The United Kingdom,EURO,27764,5812733,84,129836
2021/7/24,GB,The United Kingdom,EURO,22848,5835581,74,129910
2021/7/25,GB,The United Kingdom,EURO,22172,5857753,72,129982
2021/7/26,GB,The United Kingdom,EURO,29977,5887730,76,130058
2021/7/27,GB,The United Kingdom,EURO,29574,5917304,72,130130
2021/7/28,GB,The United Kingdom,EURO,30235,5947539,88,130218
2021/7/29,GB,The United Kingdom,EURO,28429,5975968,81,130299
2021/7/30,GB,The United Kingdom,EURO,24745,6000713,106,130405
2021/7/31,GB,The United Kingdom,EURO,20568,6021281,90,130495
2021/8/1,GB,The United Kingdom,EURO,20899,6042180,95,130590
2021/8/2,GB,The United Kingdom,EURO,29834,6072014,81,130671
2021/8/3,GB,The United Kingdom,EURO,30445,6102459,74,130745
2021/8/4,GB,The United Kingdom,EURO,32336,6134795,80,130825
2021/8/5,GB,The United Kingdom,EURO,31661,6166456,103,130928
2021/8/6,GB,The United Kingdom,EURO,28057,6194513,94,131022
2021/8/7,GB,The United Kingdom,EURO,22567,6217080,95,131117
2021/8/8,GB,The United Kingdom,EURO,22882,6239962,80,131197
2021/8/9,GB,The United Kingdom,EURO,32158,6272120,81,131278
2021/8/10,GB,The United Kingdom,EURO,31514,6303634,81,131359
2021/8/11,GB,The United Kingdom,EURO,33346,6336980,88,131447
2021/8/12,GB,The United Kingdom,EURO,31722,6368702,107,131554
2021/8/13,GB,The United Kingdom,EURO,28968,6397670,107,131661
2021/8/14,GB,The United Kingdom,EURO,25056,6422726,96,131757
2021/8/15,GB,The United Kingdom,EURO,25322,6448048,87,131844
2021/8/16,GB,The United Kingdom,EURO,36895,6484943,83,131927
2021/8/17,GB,The United Kingdom,EURO,37909,6522852,110,132037
2021/8/18,GB,The United Kingdom,EURO,38736,6561588,102,132139
2021/8/19,GB,The United Kingdom,EURO,36483,6598071,109,132248
2021/8/20,GB,The United Kingdom,EURO,32223,6630294,118,132366
2021/8/21,GB,The United Kingdom,EURO,28515,6658809,106,132472
2021/8/22,GB,The United Kingdom,EURO,28727,6687536,119,132591
2021/8/23,GB,The United Kingdom,EURO,39709,6727245,116,132707
2021/8/24,GB,The United Kingdom,EURO,37671,6764916,114,132821
2021/8/25,GB,The United Kingdom,EURO,38768,6803684,103,132924
2021/8/26,GB,The United Kingdom,EURO,37607,6841291,116,133040
2021/8/27,GB,The United Kingdom,EURO,33734,6875025,128,133168
2021/8/28,GB,The United Kingdom,EURO,27592,6902617,126,133294
2021/8/29,GB,The United Kingdom,EURO,26131,6928748,129,133423
2021/8/30,GB,The United Kingdom,EURO,34755,6963503,107,133530
2021/8/31,GB,The United Kingdom,EURO,45204,7008707,117,133647
2021/9/1,GB,The United Kingdom,EURO,43516,7052223,118,133765
2021/9/2,GB,The United Kingdom,EURO,42310,7094533,129,133894
2021/9/3,GB,The United Kingdom,EURO,38626,7133159,148,134042
2021/9/4,GB,The United Kingdom,EURO,31803,7164962,135,134177
2021/9/5,GB,The United Kingdom,EURO,31799,7196761,157,134334
2021/9/6,GB,The United Kingdom,EURO,44915,7241676,138,134472
2021/9/7,GB,The United Kingdom,EURO,38609,7280285,155,134627
2021/9/8,GB,The United Kingdom,EURO,35839,7316124,141,134768
2021/9/9,GB,The United Kingdom,EURO,33965,7350089,167,134935
2021/9/10,GB,The United Kingdom,EURO,29173,7379262,146,135081
2021/9/11,GB,The United Kingdom,EURO,23531,7402793,138,135219
2021/9/12,GB,The United Kingdom,EURO,24053,7426846,143,135362
2021/9/13,GB,The United Kingdom,EURO,34651,7461497,110,135472
2021/9/14,GB,The United Kingdom,EURO,31417,7492914,154,135626
2021/9/15,GB,The United Kingdom,EURO,30375,7523289,145,135771
2021/9/16,GB,The United Kingdom,EURO,29548,7552837,151,135922
2021/9/17,GB,The United Kingdom,EURO,29464,7582301,176,136098
2021/9/18,GB,The United Kingdom,EURO,26639,7608940,124,136222
2021/9/19,GB,The United Kingdom,EURO,31083,7640023,125,136347
2021/9/20,GB,The United Kingdom,EURO,40756,7680779,138,136485
2021/9/21,GB,The United Kingdom,EURO,38835,7719614,121,136606
2021/9/22,GB,The United Kingdom,EURO,36749,7756363,151,136757
2021/9/23,GB,The United Kingdom,EURO,35837,7792200,139,136896
2021/9/24,GB,The United Kingdom,EURO,32096,7824296,125,137021
2021/9/25,GB,The United Kingdom,EURO,28561,7852857,125,137146
2021/9/26,GB,The United Kingdom,EURO,32064,7884921,97,137243
2021/9/27,GB,The United Kingdom,EURO,41579,7926500,116,137359
2021/9/28,GB,The United Kingdom,EURO,36541,7963041,108,137467
2021/9/29,GB,The United Kingdom,EURO,34819,7997860,125,137592
2021/9/30,GB,The United Kingdom,EURO,32588,8030448,113,137705
2021/10/1,GB,The United Kingdom,EURO,29050,8059498,129,137834
2021/10/2,GB,The United Kingdom,EURO,26309,8085807,110,137944
2021/10/3,GB,The United Kingdom,EURO,32051,8117858,97,138041
2021/10/4,GB,The United Kingdom,EURO,43727,8161585,103,138144
2021/10/5,GB,The United Kingdom,EURO,39263,8200848,120,138264
2021/10/6,GB,The United Kingdom,EURO,39255,8240103,103,138367
2021/10/7,GB,The United Kingdom,EURO,38462,8278565,123,138490
2021/10/8,GB,The United Kingdom,EURO,35597,8314162,120,138610
2021/10/9,GB,The United Kingdom,EURO,32296,8346458,117,138727
2021/10/10,GB,The United Kingdom,EURO,36406,8382864,96,138823
2021/10/11,GB,The United Kingdom,EURO,50285,8433149,125,138948
2021/10/12,GB,The United Kingdom,EURO,48299,8481448,115,139063
2021/10/13,GB,The United Kingdom,EURO,47765,8529213,121,139184
2021/10/14,GB,The United Kingdom,EURO,46412,8575625,149,139333
2021/10/15,GB,The United Kingdom,EURO,43545,8619170,139,139472
2021/10/16,GB,The United Kingdom,EURO,37872,8657042,133,139605
2021/10/17,GB,The United Kingdom,EURO,43747,8700789,129,139734
2021/10/18,GB,The United Kingdom,EURO,57728,8758517,127,139861
2021/10/19,GB,The United Kingdom,EURO,52511,8811028,128,139989
2021/10/20,GB,The United Kingdom,EURO,51650,8862678,154,140143
2021/10/21,GB,The United Kingdom,EURO,45193,8907871,157,140300
2021/10/22,GB,The United Kingdom,EURO,40658,8948529,136,140436
2021/10/23,GB,The United Kingdom,EURO,35096,8983625,165,140601
2021/10/24,GB,The United Kingdom,EURO,35757,9019382,152,140753
2021/10/25,GB,The United Kingdom,EURO,47447,9066829,134,140887
2021/10/26,GB,The United Kingdom,EURO,42109,9108938,164,141051
2021/10/27,GB,The United Kingdom,EURO,43035,9151973,162,141213
2021/10/28,GB,The United Kingdom,EURO,41374,9193347,192,141405
2021/10/29,GB,The United Kingdom,EURO,40239,9233586,171,141576
2021/10/30,GB,The United Kingdom,EURO,33556,9267142,169,141745
2021/10/31,GB,The United Kingdom,EURO,34794,9301936,188,141933
2021/11/1,GB,The United Kingdom,EURO,45102,9347038,177,142110
2021/11/2,GB,The United Kingdom,EURO,38007,9385045,158,142268
2021/11/3,GB,The United Kingdom,EURO,35972,9421017,165,142433
2021/11/4,GB,The United Kingdom,EURO,33652,9454669,156,142589
2021/11/5,GB,The United Kingdom,EURO,30313,9484982,159,142748
2021/11/6,GB,The United Kingdom,EURO,27430,9512412,169,142917
2021/11/7,GB,The United Kingdom,EURO,30582,9542994,168,143085
2021/11/8,GB,The United Kingdom,EURO,44122,9587116,154,143239
2021/11/9,GB,The United Kingdom,EURO,42237,9629353,149,143388
2021/11/10,GB,The United Kingdom,EURO,42926,9672279,148,143536
2021/11/11,GB,The United Kingdom,EURO,40986,9713265,143,143679
2021/11/12,GB,The United Kingdom,EURO,37758,9751023,149,143828
2021/11/13,GB,The United Kingdom,EURO,32879,9783902,136,143964
2021/11/14,GB,The United Kingdom,EURO,35505,9819407,126,144090
2021/11/15,GB,The United Kingdom,EURO,50946,9870353,174,144264
2021/11/16,GB,The United Kingdom,EURO,46418,9916771,153,144417
2021/11/17,GB,The United Kingdom,EURO,45888,9962659,126,144543
2021/11/18,GB,The United Kingdom,EURO,44050,10006709,136,144679
2021/11/19,GB,The United Kingdom,EURO,39589,10046298,124,144803
2021/11/20,GB,The United Kingdom,EURO,35327,10081625,130,144933
2021/11/21,GB,The United Kingdom,EURO,37245,10118870,106,145039
2021/11/22,GB,The United Kingdom,EURO,50721,10169591,119,145158
2021/11/23,GB,The United Kingdom,EURO,48182,10217773,143,145301
2021/11/24,GB,The United Kingdom,EURO,46759,10264532,116,145417
2021/11/25,GB,The United Kingdom,EURO,43409,10307941,137,145554
2021/11/26,GB,The United Kingdom,EURO,39324,10347265,132,145686
2021/11/27,GB,The United Kingdom,EURO,33290,10380555,107,145793
2021/11/28,GB,The United Kingdom,EURO,39692,10420247,118,145911
2021/11/29,GB,The United Kingdom,EURO,56283,10476530,124,146035
2021/11/30,GB,The United Kingdom,EURO,55685,10532215,96,146131
2021/12/1,GB,The United Kingdom,EURO,54809,10587024,124,146255
2021/12/2,GB,The United Kingdom,EURO,50303,10637327,107,146362
2021/12/3,GB,The United Kingdom,EURO,45659,10682986,130,146492
2021/12/4,GB,The United Kingdom,EURO,38779,10721765,147,146639
2021/12/5,GB,The United Kingdom,EURO,41014,10762779,111,146750
2021/12/6,GB,The United Kingdom,EURO,59664,10822443,138,146888
2021/12/7,GB,The United Kingdom,EURO,56228,10878671,121,147009
2021/12/8,GB,The United Kingdom,EURO,58789,10937460,113,147122
2021/12/9,GB,The United Kingdom,EURO,56978,10994438,125,147247
2021/12/10,GB,The United Kingdom,EURO,52476,11046914,109,147356
2021/12/11,GB,The United Kingdom,EURO,48590,11095504,96,147452
2021/12/12,GB,The United Kingdom,EURO,53139,11148643,121,147573
2021/12/13,GB,The United Kingdom,EURO,87151,11235794,104,147677
2021/12/14,GB,The United Kingdom,EURO,102751,11338545,128,147805
2021/12/15,GB,The United Kingdom,EURO,112672,11451217,113,147918
2021/12/16,GB,The United Kingdom,EURO,106036,11557253,105,148023
2021/12/17,GB,The United Kingdom,EURO,95866,11653119,129,148152
2021/12/18,GB,The United Kingdom,EURO,88876,11741995,107,148259
2021/12/19,GB,The United Kingdom,EURO,89125,11831120,102,148361
2021/12/20,GB,The United Kingdom,EURO,133943,11965063,124,148485
2021/12/21,GB,The United Kingdom,EURO,150268,12115331,100,148585
2021/12/22,GB,The United Kingdom,EURO,161530,12276861,126,148711
2021/12/23,GB,The United Kingdom,EURO,160619,12437480,131,148842
2021/12/24,GB,The United Kingdom,EURO,137259,12574739,127,148969
2021/12/25,GB,The United Kingdom,EURO,70355,12645094,107,149076
2021/12/26,GB,The United Kingdom,EURO,116258,12761352,116,149192
2021/12/27,GB,The United Kingdom,EURO,194967,12956319,142,149334
2021/12/28,GB,The United Kingdom,EURO,212421,13168740,168,149502
2021/12/29,GB,The United Kingdom,EURO,272743,13441483,125,149627
2021/12/30,GB,The United Kingdom,EURO,236538,13678021,190,149817
2021/12/31,GB,The United Kingdom,EURO,188510,13866531,169,149986
2022/1/1,GB,The United Kingdom,EURO,118179,13984710,181,150167
2022/1/2,GB,The United Kingdom,EURO,181018,14165728,176,150343
2022/1/3,GB,The United Kingdom,EURO,229829,14395557,179,150522
2022/1/4,GB,The United Kingdom,EURO,275599,14671156,220,150742
2022/1/5,GB,The United Kingdom,EURO,222094,14893250,213,150955
2022/1/6,GB,The United Kingdom,EURO,172875,15066125,257,151212
2022/1/7,GB,The United Kingdom,EURO,120243,15186368,250,151462
2022/1/8,GB,The United Kingdom,EURO,93555,15279923,242,151704
2022/1/9,GB,The United Kingdom,EURO,95709,15375632,272,151976
2022/1/10,GB,The United Kingdom,EURO,132674,15508306,278,152254
2022/1/11,GB,The United Kingdom,EURO,115179,15623485,269,152523
2022/1/12,GB,The United Kingdom,EURO,103141,15726626,260,152783
2022/1/13,GB,The United Kingdom,EURO,96319,15822945,284,153067
2022/1/14,GB,The United Kingdom,EURO,86240,15909185,280,153347
2022/1/15,GB,The United Kingdom,EURO,77879,15987064,295,153642
2022/1/16,GB,The United Kingdom,EURO,98003,16085067,293,153935
2022/1/17,GB,The United Kingdom,EURO,131380,16216447,296,154231
2022/1/18,GB,The United Kingdom,EURO,118670,16335117,288,154519
2022/1/19,GB,The United Kingdom,EURO,111648,16446765,281,154800
2022/1/20,GB,The United Kingdom,EURO,100224,16546989,256,155056
2022/1/21,GB,The United Kingdom,EURO,91507,16638496,307,155363
2022/1/22,GB,The United Kingdom,EURO,81645,16720141,282,155645
2022/1/23,GB,The United Kingdom,EURO,102308,16822449,256,155901
2022/1/24,GB,The United Kingdom,EURO,127240,16949689,280,156181
2022/1/25,GB,The United Kingdom,EURO,113114,17062803,245,156426
2022/1/26,GB,The United Kingdom,EURO,108633,17171436,264,156690
2022/1/27,GB,The United Kingdom,EURO,96140,17267576,301,156991
2022/1/28,GB,The United Kingdom,EURO,83986,17351562,257,157248
2022/1/29,GB,The United Kingdom,EURO,73466,17425028,261,157509
2022/1/30,GB,The United Kingdom,EURO,87514,17512542,245,157754
2022/1/31,GB,The United Kingdom,EURO,104886,17617428,258,158012
2022/2/1,GB,The United Kingdom,EURO,93728,17711156,264,158276
2022/2/2,GB,The United Kingdom,EURO,88374,17799530,249,158525
2022/2/3,GB,The United Kingdom,EURO,76568,17876098,229,158754
2022/2/4,GB,The United Kingdom,EURO,63159,17939257,195,158949
2022/2/5,GB,The United Kingdom,EURO,52271,17991528,219,159168
2022/2/6,GB,The United Kingdom,EURO,60516,18052044,208,159376
2022/2/7,GB,The United Kingdom,EURO,76442,18128486,180,159556
2022/2/8,GB,The United Kingdom,EURO,69603,18198089,189,159745
2022/2/9,GB,The United Kingdom,EURO,64266,18262355,179,159924
2022/2/10,GB,The United Kingdom,EURO,52248,18314603,181,160105
2022/2/11,GB,The United Kingdom,EURO,44515,18359118,164,160269
2022/2/12,GB,The United Kingdom,EURO,37401,18396519,165,160434
2022/2/13,GB,The United Kingdom,EURO,41722,18438241,174,160608
2022/2/14,GB,The United Kingdom,EURO,54662,18492903,190,160798
2022/2/15,GB,The United Kingdom,EURO,52444,18545347,174,160972
2022/2/16,GB,The United Kingdom,EURO,51513,18596860,169,161141
2022/2/17,GB,The United Kingdom,EURO,44667,18641527,160,161301
2022/2/18,GB,The United Kingdom,EURO,33214,18674741,156,161457
2022/2/19,GB,The United Kingdom,EURO,34639,18709380,156,161613
2022/2/20,GB,The United Kingdom,EURO,37665,18747045,164,161777
2022/2/21,GB,The United Kingdom,EURO,45087,18792132,145,161922
2022/2/22,GB,The United Kingdom,EURO,39114,18831246,139,162061
2022/2/23,GB,The United Kingdom,EURO,36439,18867685,146,162207
2022/2/24,GB,The United Kingdom,EURO,30583,18898268,167,162374
2022/2/25,GB,The United Kingdom,EURO,27799,18926067,145,162519
2022/2/26,GB,The United Kingdom,EURO,25054,18951121,134,162653
2022/2/27,GB,The United Kingdom,EURO,31335,18982456,136,162789
2022/2/28,GB,The United Kingdom,EURO,44592,19027048,145,162934
2022/3/1,GB,The United Kingdom,EURO,44729,19071777,133,163067
2022/3/2,GB,The United Kingdom,EURO,46129,19117906,161,163228
2022/3/3,GB,The United Kingdom,EURO,43699,19161605,157,163385
2022/3/4,GB,The United Kingdom,EURO,41352,19202957,133,163518
2022/3/5,GB,The United Kingdom,EURO,38714,19241671,127,163645
2022/3/6,GB,The United Kingdom,EURO,48976,19290647,130,163775
2022/3/7,GB,The United Kingdom,EURO,68455,19359102,149,163924
2022/3/8,GB,The United Kingdom,EURO,70011,19429113,147,164071
2022/3/9,GB,The United Kingdom,EURO,73427,19502540,143,164214
2022/3/10,GB,The United Kingdom,EURO,70414,19572954,153,164367
2022/3/11,GB,The United Kingdom,EURO,66949,19639903,143,164510
2022/3/12,GB,The United Kingdom,EURO,61983,19701886,144,164654
2022/3/13,GB,The United Kingdom,EURO,75632,19777518,154,164808
2022/3/14,GB,The United Kingdom,EURO,99716,19877234,185,164993
2022/3/15,GB,The United Kingdom,EURO,93501,19970735,155,165148
2022/3/16,GB,The United Kingdom,EURO,91481,20062216,184,165332
2022/3/17,GB,The United Kingdom,EURO,82748,20144964,187,165519
2022/3/18,GB,The United Kingdom,EURO,75213,20220177,205,165724
2022/3/19,GB,The United Kingdom,EURO,67329,20287506,193,165917
2022/3/20,GB,The United Kingdom,EURO,80989,20368495,204,166121
2022/3/21,GB,The United Kingdom,EURO,109212,20477707,180,166301
2022/3/22,GB,The United Kingdom,EURO,98979,20576686,228,166529
2022/3/23,GB,The United Kingdom,EURO,94066,20670752,203,166732
2022/3/24,GB,The United Kingdom,EURO,82785,20753537,210,166942
2022/3/25,GB,The United Kingdom,EURO,72379,20825916,224,167166
2022/3/26,GB,The United Kingdom,EURO,61410,20887326,212,167378
2022/3/27,GB,The United Kingdom,EURO,68274,20955600,225,167603
2022/3/28,GB,The United Kingdom,EURO,92679,21048279,213,167816
2022/3/29,GB,The United Kingdom,EURO,79935,21128214,236,168052
2022/3/30,GB,The United Kingdom,EURO,73476,21201690,226,168278
2022/3/31,GB,The United Kingdom,EURO,54570,21256260,250,168528
2022/4/1,GB,The United Kingdom,EURO,47283,21303543,242,168770
2022/4/2,GB,The United Kingdom,EURO,37453,21340996,242,169012
2022/4/3,GB,The United Kingdom,EURO,42002,21382998,219,169231
2022/4/4,GB,The United Kingdom,EURO,53403,21436401,232,169463
2022/4/5,GB,The United Kingdom,EURO,48689,21485090,223,169686
2022/4/6,GB,The United Kingdom,EURO,44298,21529388,232,169918
2022/4/7,GB,The United Kingdom,EURO,38027,21567415,188,170106
2022/4/8,GB,The United Kingdom,EURO,31916,21599331,113,170219
2022/4/9,GB,The United Kingdom,EURO,26850,21626181,75,170294
2022/4/10,GB,The United Kingdom,EURO,28952,21655133,79,170373
2022/4/11,GB,The United Kingdom,EURO,24151,21679284,22,170395
